For the first time since you stepped onstage, you notice how hard your heart is beating.

[Press any key.]

I beg your pardon?

I beg your pardon?

>next
It's been almost two months since I graduated. God, what did I think was going to happen when I moved to New York?

"Oh, hello, Desmond, it's me, Mr. Tall! Residency at my jazz club because you're so cool! And I'll pay off your $40,000 jazz-school debt!".

[Type next.]

* * *

I beg your pardon?

>help
How to play (quick)

Try short, simple commands.
 LOOK (or L) - refresh the room view
 EXAMINE (or X) things - e.g., X MAGAZINE, X PAGES
 OPEN/CLOSE/TAKE/READ
 PLAY (INSTRUMENT)
 NEXT / PREVIOUS (PAGE)- flip pages
 DIAL (PHONE NUMBER) (from the wall phone)
 ANSWER PHONE when it rings
 N/W/E/S - go in a direction (only if you have somewhere to go)

>X POSTERS
There's a poster of Charlie Parker. Isn't that nice? You've also got one of Sun Ra. Who do you think you are, bro? It's actually kind of cool. I bet girls will really love that one when they come over-not.

>OPEN BIOLLS
You can't see any such thing.

>OPEN BILLS
You peel the rubber band and spread things out: a friendly envelope, a landlord envelope, a ConEd envelope, and a stiff university envelope.

>OPEN CONED
You open the coned envelope, revealing an electric bill.

>OPEN LANDLORD
You open the landlord envelope, revealing a rent notice.

>OPEN UNIVERSITY
You open the professor envelope, revealing a professor letter.

>X LETTER
Dear Desmond,

Congratulations on your graduation. I suppose four years is better than five, though I must admit I expected more consistent dedication from someone with your raw talent.

Your senior recital was... adequate. That flubbed entrance in "Epistrophe" still haunts me (Monk's rolling around in his grave), if I'm being honest. You had the technique but never the discipline to play the changes correctly. Always rushing, always pushing ahead of the beat like you were trying to escape something.

Nevertheless, you've earned your degree. I hope New York treats you well. Do try to apply yourself more diligently than you did in your counterpoint studies.

Sincerely,
Professor Albright

> What an asshole. Thank god that period of my life is over. Why would a professor vibe me like that, every day, in and out.

> Jazz Dictionary:
> Entry 283

> Vibe (v), not to be confused with vibe (n)

       To give someone bad vibes; to subtly undermine or disrespect a fellow musician through passive-aggressive behavior, audible sighs, whispered comments, or playing "correct" changes over someone's intentional substitutions. The jazz equivalent of throwing shade.

>x window
(the window)
Streetlights smear across the glass; the city hums behind it. Why the hell did you come here in the first place. The sunset is nice, though-it reminds you of home. A disposable camera is sunbathing on the sill like it's going to take pictures of itself.

>play camera
You can't see any such thing.

>open camera
You can't see any such thing.

>x camera
You can't see any such thing.

>x streetlights
A low, constant hush: buses sighing, a scooter whining three octaves too high, someone laughing like midnight owes them money. On the corner, a Village Voice box losing a fight with gravity. Also a guy yelling at the library. Like, at the outside of the library. Who knows?

>l guy
You can't see any such thing.

>l library
You can't see any such thing.

>l
Studio
You look around your tiny studio apartment, tucked into a corner of 178th street. "Uptown Manhattan," as someone once described it. There's a magazine on the counter, and some bills and mail pile up slowly, your pills sit on the table next to the mail. 

Posters hang on the walls. Your friend's LP is playing on an old turntable in the corner. It's insane you haven't cleaned this place once since you've moved here. A couch is pushed up against a big window, a grimy, scuffed rug underfoot, instruments everywhere, a kitchen nook just over there-and the apartment door to the west.

type "help" for help.

>l instruments
Which do you mean, the saxophone, the guitar or the instruments?

>play guitar
A gentle pattern, thumb and nail. The room exhales.

>play instruments
Which do you mean, the saxophone, the guitar or the instruments?

>play others
You can't see any such thing.

>play containers
Which do you mean, the milk crate, the orange pill bottle, the cabinet, the fridge, the some bills and mail, the professor envelope, the friendly envelope, the landlord envelope or the coned envelope?

>x pill bottle
Orange pharmacy bottle, white childproof cap, your name half-scratched off. You shake it: no rattle. Empty since last week. A card for your therapist sits nearby.

>dial therapist
You reach for where a cell *would* be. The wall phone's across the room-try GO TO PHONE first.

>go to phone
You step up to the wall phone.

>dial therapist
You tap the keypad: dr. levy.
Dial tone, then a recorded pause. Either wrong number or the city is feeling shy tonight.

>l milk crate
A black plastic crate stuffed with sleeves: classics, thrift finds, and a few you definitely "borrowed" from friends.

In the milk crate are a "Kind of Blue" LP, a "Blue Train" LP, a "Soul Station" LP, a "A Love Supreme" LP and a "Mingus Ah Um" LP.

*BRRRRING* The wall phone bursts to life. (ANSWER PHONE to pick up.)

>answer phone
"It's Rena." Not a question. The voice carries last night's cigarettes and this morning's coffee. You can hear the faint hiss of street traffic behind her words. "Tall's. Late jam. You're coming." There's a pause filled with the sound of a lighter flicking, then an exhale.

1) "Am I? Tell me why."
2) "Tonight? I'm destroyed."
3) "Rena who?"

[Type 1, 2, or 3.]

>1
"Late set. House trio is killing, horns rotate in, everyone listens. You need to be seen." She takes another drag. "Kenji's on bass tonight. You remember Kenji - he was at that warehouse thing in Red Hook. Said you had decent time but your altissimo sounds like a dying cat."

1) "What's your angle here?"
2) "I'm not going."
3) "Is this an open thing or do I need an in?"

>1
"Because you have that freshly-graduated, "I'm unique" sound. That window closes in about six months." Traffic noise swells then fades. "Room's small, ceiling's low, everyone's had two drinks minimum. You call a tune, play the form, don't overplay the bridge. If you listen, they remember. If you showboat, they remember differently." Beat. "Marcus will be there. He books the Tuesday residency at Zinc." Another beat. "You know what a residency pays? It pays your ConEd bill, that's what."

1) "What if I choke?"
2) "What time?"
3) "Who else is playing?"

>2
Well, I suppose I'd better figure out how to get there.

* * *

I beg your pardon?

>nexytt
[Press Enter or type NEXT.]

>nrxt
[Press Enter or type NEXT.]

>nezt
[Press Enter or type NEXT.]

>next
It's been almost two months since I graduated. God, what did I think was going to happen when I moved to New York?

"Oh, hello, Desmond, it's me, Mr. Tall! Residency at my jazz club because you're so cool! And I'll pay off your $40,000 jazz-school debt!"

[Press Enter or type NEXT.]

>next
Stupid. That's stupid. And I'm talking to myself again.

[Press Enter or type NEXT.]

>next
It took a long time to move here. Dad helped. He always helps in a way that leaves a little extra for me to carry after.

[Press Enter or type NEXT.]

>next
Studio
You look around your tiny studio apartment, tucked into a corner of 178th street. "Uptown Manhattan," as someone once described it. There's a magazine on the counter, and some bills and mail pile up slowly. It's insane you haven't cleaned this place once since you've moved here. A couch is pushed up against a big window, a grimy, scuffed rug underfoot, instruments everywhere, a kitchen nook just over there-and the apartment door to the west.

You can see a door, a couch, a saxophone, a guitar, a some bills and mail (closed) and a magazine here.

>look couch
It's certainly seen better days, but still the best place to crash between gigs. Don't try to look between the cushions.

>look cushions
Dude. I told you not to look between the cushions. There's nothing here. Surprise.

* * *

For the first time since you stepped onstage, you notice how hard your heart is beating.

[Press any key.]

>z z z
I only understood you as far as wanting to wait.

>z z
I only understood you as far as wanting to wait.

>z z
I only understood you as far as wanting to wait.

>z
Time passes.

>z
Time passes.

I beg your pardon?

>z
Time passes.

>z
Time passes.

*BRRRRING* The wall phone bursts to life. (ANSWER PHONE to pick up.)

>z
Time passes.

>zanswe
I didn't understand that sentence.

>answer
"It's Rena." Not a question. The voice carries last night's cigarettes and this morning's coffee. You can hear the faint hiss of street traffic behind her words. "Tall's. Late jam. You're coming." There's a pause filled with the sound of a lighter flicking, then an exhale.

1) "Am I? Tell me why."
2) "Tonight? I'm destroyed."
3) "Rena who?"

[Type 1, 2, or 3.]

>1
"Late set. House trio is killing, horns rotate in, everyone listens. You need to be seen." She takes another drag. "Kenji's on bass tonight. You remember Kenji - he was at that warehouse thing in Red Hook. Said you had decent time but your altissimo sounds like a dying cat."

1) "What's your angle here?"
2) "I'm not going."
3) "Is this an open thing or do I need an in?"

* * *

>1
"Because you have that freshly-graduated, "I'm unique" sound. That window closes in about six months." Traffic noise swells then fades. "Room's small, ceiling's low, everyone's had two drinks minimum. You call a tune, play the form, don't overplay the bridge. If you listen, they remember. If you showboat, they remember differently." Beat. "Marcus will be there. He books the Tuesday residency at Zinc." Another beat. "You know what a residency pays? It pays your ConEd bill, that's what."

1) "What if I choke?"
2) "What time?"
3) "Who else is playing?"

>1
Well, I suppose I'd better figure out how to get there.

>take sax
Taken.

>1
I didn't understand that sentence.

>1
I didn't understand that sentence.

>w
(first opening the door)

Hallway
Dim, echoey. Stairs down to the street, smell of dust and last night's takeout.

>down
Subway - pick a stop:
1) Delancey-Essex
2) Spring St (6)
3) Prince St (R/W)
4) Canal St (A/C/E)
5) Hoyt-Schermerhorn
6) 14 St-Union Sq
7) W 4 St-Wash Sq
8) 34 St-Herald Sq
9) Times Sq-42 St
10) Grand St (B/D)
11) Bedford Av (L)
12) Atlantic Av-Barclays Ctr
13) 2 Av (F)
14) Broadway-Lafayette
15) Essex St (J/M/Z)
16) 1 Av (L)
17) 7 Av-Park Slope
18) Nostrand Av (A/C)
19) Queensboro Plaza
20) Myrtle-Wyckoff Avs

[Type a number (1-20).]
(subway)

>1
Subway Train Correct
The F train rumbling downtown. The old man watches you with patient curiosity.

The downtown F train rattles through the tunnel, a metallic heartbeat under the city. The car is half-empty-a few late-shift workers, a couple making out by the doors, and an old man with a weathered face and kind eyes sitting across from you. He nods at your sax case.

"That a sax?" he asks, his voice gravelly like he's smoked a thousand cigarettes and drunk a thousand cups of coffee.

1) "Yeah, tenor."
2) "Just heading to a jam."
3) Nod silently

>1
"Tenor," he repeats, like he's tasting the word. "My son played tenor. What kind you got there?"

1) "Selmer Mark VI."
2) "Just a student model."
3) "Why?"

>1
"Selmer," he says, his eyes getting distant. "My boy had one just like it. Said it was the only horn that ever felt like home." He looks out the window at the dark tunnel. "He passed last year. Cancer." The train rattles on. "Play something beautiful tonight, kid. For him."

The train slows into Delancey Street. "This is you," he says. As you stand to leave, he adds, "Remember-it's just music. The notes will be there tomorrow, no matter what happens tonight."

Delancey Street
Lower East Side: neon bleed, late traffic, bass thumping from a basement somewhere. A red door marked Tall's crouches under a short run of stairs. (And yeah-the address matches the magazine: 184 Ludlow.) The sound of a piano trio filters through the door-someone playing "Autumn Leaves" with more feeling than you thought possible tonight.

>go in
You can't go that way.

>go in the door
Your hand finds the cold brass knob. Through the wood, you can feel the vibration of the bass, the shimmer of the ride cymbal. Your heart is pounding so hard you're sure everyone on the street can hear it.

This is it. You could still turn around. Take the train back uptown. Watch TV. Pretend this never happened.

But then you think of the old man on the train. Your dad's horn in its case. The empty pill bottle on your counter. The professor's letter. All the reasons to run, and the one reason to stay.

You take a deep breath.

Do you go in? (Type IN/YES or OUT/NO.)

>yes
You turn the knob and push.

The door gives way to darkness, cigarette smoke, and the sound of a room holding its breath. The piano player looks up, nods. The bassist makes space in the time.

You step inside.

CHAPTER 1 END

    *** The End ***

Would you like to RESTART, RESTORE a saved game, QUIT or UNDO the last command?

>undo
Delancey Street
[Previous turn undone.]

>l
You're at the threshold. Type IN/YES to enter or OUT/NO to walk away.

>no
You let go of the knob. Your hand is shaking.

You turn away from the door, from the music, from whatever might have been. The city swallows you whole as you walk back toward the subway, the sound of your own footsteps the only rhythm you'll hear tonight.

CHAPTER 1 END

    *** The End ***

Would you like to RESTART, RESTORE a saved game, QUIT or UNDO the last command?

>q
Please give one of the answers above.

Would you like to RESTART, RESTORE a saved game, QUIT or UNDO the last command?

* * *

For the first time since you stepped onstage, you notice how hard your heart is beating.

[Press any key.]

>.
I didn't understand that sentence.

I beg your pardon?

* * *

>z
Time passes.

>2
I didn't understand that sentence.

I beg your pardon?

>2
I didn't understand that sentence.

>2
I didn't understand that sentence.

>answer
"It's Rena." Not a question. The voice carries last night's cigarettes and this morning's coffee. You can hear the faint hiss of street traffic behind her words. "Tall's. Late jam. You're coming." There's a pause filled with the sound of a lighter flicking, then an exhale.

1) "Am I? Tell me why."
2) "Tonight? I'm destroyed."
3) "Rena who?"

[Type 1, 2, or 3.]

* * *

>1
Well, I suppose I'd better figure out how to get there.

>w
Forgetting something?

>take saxophone
That's hardly portable.

* * *

For the first time since you stepped onstage, you notice how hard your heart is beating.

[Press any key.]

>d
You can't go that way.

>down
You can't go that way.

>x
What do you want to examine?

>x
What do you want to examine?

I beg your pardon?

>x
What do you want to examine?

>z
Time passes.

>zanswer
I didn't understand that sentence.

>answer
"It's Rena." Not a question. The voice carries last night's cigarettes and this morning's coffee. "Tall's. Late jam. You're coming."

1) "Am I? Tell me why."
2) "Tonight? I'm destroyed."
3) "Rena who?"

[Type 1, 2, or 3.]

>2
"Good. Exhausted reads honest." A lighter flicks on her end. "One tune. Make it not embarrassing. Three people in that room book gigs. That's it. That's the math."

1) "One tune gets me what, exactly?"
2) "Not interested."
3) "Walking into a jam cold sounds like a bad idea."

>2
Well, I suppose I'd better figure out how to get there.

>d
(first getting off the phone nook)
You step back from the wall phone.

You can't go that way.

>d
You can't go that way.

>leave the room
I only understood you as far as wanting to leave.

>leave through the door
I only understood you as far as wanting to leave.

>leave the room through the door
I only understood you as far as wanting to leave.

>go out the door
I only understood you as far as wanting to go outside.

>go to the door
You can't see any such thing.

>look door
You see nothing special about the door.

>exit
But you aren't in anything at the moment.

>go downstairs
You can't see any such thing.

>leave
But you aren't in anything at the moment.

>w
Forgetting something?

>leave apartment
Forgetting something?

>leave
But you aren't in anything at the moment.

* * *

For the first time since you stepped onstage, you notice how hard your heart is beating.

[Press any key.]

>help
How to play (quick)

Try short, simple commands.
 LOOK (or L) - refresh the room view
 EXAMINE (or X) things - e.g., X MAGAZINE, X PAGES
 OPEN/CLOSE/TAKE/READ
 PLAY SAXOPHONE / PLAY GUITAR
 NEXT / PREVIOUS - flip the magazine
 DIAL 555-0199 (from the wall phone)
 ANSWER PHONE when it rings;  LEAVE or GO WEST - head out (only after you have somewhere to go)

* * *

For the first time since you stepped onstage, you notice how hard your heart is beating.

[Press any key.]

>l
[type next.]

* * *

For the first time since you stepped onstage, you notice how hard your heart is beating.

[Press any key.]

>leavw
I didn't understand that sentence.

>leave
But you aren't in anything at the moment.

>exit apartment
I only understood you as far as wanting to exit.

>w
You can't go that way.

>w
You can't go that way.

>l
Studio
You look around your tiny studio apartment, tucked into a corner of 178th street. "Uptown Manhattan," as someone once described it. There's a magazine on the counter, and some bills and mail pile up slowly. 

Posters hang on the walls. Your friend's LP is playing on an old turntable in the corner. It's insane you haven't cleaned this place once since you've moved here. A couch is pushed up against a big window, a grimy, scuffed rug underfoot, instruments everywhere, a kitchen nook just over there-and the apartment door to the west.

>w
You can't go that way.

* * *

For the first time since you stepped onstage, you notice how hard your heart is beating.

[Press any key.]

>look at mail
A rubber-banded stack: some official windows, some handwritten. You could open this pile. A pill bottle sits next to the stack.

>open mail
You peel the rubber band and spread things out: a friendly envelope, a landlord envelope, a ConEd envelope, and a stiff university envelope.

>open university envelope
You open the professor envelope, revealing a professor letter.

>read letter
Dear Desmond,

Congratulations on your graduation. I suppose four years is better than five, though I must admit I expected more consistent dedication from someone with your raw talent.

Your senior recital was... adequate. That flubbed entrance in "Giant Steps" still haunts me, if I'm being honest. You had the technique but never the discipline to play the changes correctly. Always rushing, always pushing ahead of the beat like you were trying to escape something.

Nevertheless, you've earned your degree. I hope New York treats you well. Do try to apply yourself more diligently than you did in your counterpoint studies.

Sincerely,
Professor Albright

* * *

For the first time since you stepped onstage, you notice how hard your heart is beating.

[Press any key.]

>look letters
A rubber-banded stack: some official windows, some handwritten. You could open this pile. A pill bottle sits next to the stack.

>open them
I'm not sure what 'them' refers to.

>open the letters
You peel the rubber band and spread things out: a friendly envelope, a landlord envelope, a ConEd envelope, and a stiff university envelope.

>open university
You open the professor envelope, revealing a professor letter.

>read it
Crisp university stationery. The return address is from the music department. Smells like regret and toner.

In the professor envelope is a professor letter.

>read it
Crisp university stationery. The return address is from the music department. Smells like regret and toner.

In the professor envelope is a professor letter.

>read the letter
Dear Desmond,

Congratulations on your graduation. I suppose four years is better than five, though I must admit I expected more consistent dedication from someone with your raw talent.

Your senior recital was... adequate. That flubbed entrance in "Epistrophe" still haunts me (Monk's rolling around in his grave), if I'm being honest. You had the technique but never the discipline to play the changes correctly. Always rushing, always pushing ahead of the beat like you were trying to escape something.

Nevertheless, you've earned your degree. I hope New York treats you well. Do try to apply yourself more diligently than you did in your counterpoint studies.

Sincerely,
Professor Albright

> What an asshole. Thank god that period of my life is over. Why would a professor vibe me like that, every day, in and out.

      Jazz Dictionary:
       Entry 283

        Vibe (v), not to be confused with vibe (n)

       To give someone bad vibes; to subtly undermine or disrespect a fellow musician through passive-aggressive behavior, audible sighs, whispered comments, or playing "correct" changes over someone's intentional substitutions. The jazz equivalent of throwing shade.

* * *

For the first time since you stepped onstage, you notice how hard your heart is beating.

[Press any key.]

>look mail
A rubber-banded stack: some official windows, some handwritten. You could open this pile. A pill bottle sits next to the stack.

>open
What do you want to open?

>open mail
You peel the rubber band and spread things out: a friendly envelope, a landlord envelope, a ConEd envelope, and a stiff university envelope.

>open university
You open the professor envelope, revealing a professor letter.

>open
What do you want to open?

>real
You can't see any such thing.

>read
What do you want to read?

>letter
Dear Desmond,

Congratulations on your graduation. I suppose four years is better than five, though I must admit I expected more consistent dedication from someone with your raw talent.

Your senior recital was... adequate. That flubbed entrance in "Epistrophe" still haunts me (Monk's rolling around in his grave), if I'm being honest. You had the technique but never the discipline to play the changes correctly. Always rushing, always pushing ahead of the beat like you were trying to escape something.

Nevertheless, you've earned your degree. I hope New York treats you well. Do try to apply yourself more diligently than you did in your counterpoint studies.

Sincerely,
Professor Albright

> What an asshole

* * *

For the first time since you stepped onstage, you notice how hard your heart is beating.

[Press any key.]

>next
It's been almost two months since I graduated. Go, class of 2002! Just kidding. God, what did I think was going to happen when I moved to New York?

"Oh, hello, Desmond, it's me, Mr. Tall! Residency at my jazz club because you're so cool! And I'll pay off your $40,000 jazz-school debt!"

[type next.]

>next
Stupid. That's stupid. And I'm talking to myself again.

[type next.]

>next
It took a long time to move here. Dad helped. He always helps in a way that leaves a little extra for me to carry after.

You put a record on your tiny AT turntable in the corner of your place. Jazz floods the room.

[type next.]

>next
Studio

You look around your tiny studio apartment, tucked into a corner of 178th street. "Uptown Manhattan," as someone once described it. There's a magazine on the counter, and some bills and mail pile up slowly. 

Posters hang on the walls. Your friend's LP is playing on an old turntable in the corner. It's insane you haven't cleaned this place once since you've moved here. A couch is pushed up against a big window, a grimy, scuffed rug underfoot, instruments everywhere, a kitchen nook just over there-and the apartment door to the west.

I beg your pardon?

* * *

>z
Time passes.

>answer phone
"Hey. It's Rena." The voice sits somewhere between a yawn and a dare. "You should come out-Tall's is running a late jam tonight."

1) "What's up? Sell me."
2) "Tonight? I'm wrecked."
3) "Rena who?"

[Type 1, 2, or 3. HANG UP to end the call.]

>2
"Wrecked's fine. Play one tune, drink one drink, shake three hands. That's all. You'll thank me tomorrow."

1) "One tune, huh? Convince me."
2) "Pass."
3) "Feels risky without a call."

>2
"Fine. Be tired on stage. Two choruses and bounce. Tall's. Tonight." The confidence leaves no wedge for argument.
You draw breath to ask where it is-click. Dead line. No address.

>2
I didn't understand that sentence.

>w
Subway - pick a stop:
1) Delancey-Essex
2) Spring St (6)
3) Prince St (R/W)
4) Canal St (A/C/E)
5) Hoyt-Schermerhorn
6) 14 St-Union Sq
7) W 4 St-Wash Sq
8) 34 St-Herald Sq
9) Times Sq-42 St
10) Grand St (B/D)
11) Bedford Av (L)
12) Atlantic Av-Barclays Ctr
13) 2 Av (F)
14) Broadway-Lafayette
15) Essex St (J/M/Z)
16) 1 Av (L)
17) 7 Av-Park Slope
18) Nostrand Av (A/C)
19) Queensboro Plaza
20) Myrtle-Wyckoff Avs

[Type a number (1-20).]
(subway)

>5
Where the fuck am I? Maybe actually figure out where Tall's is first.

>5
I didn't understand that sentence.

* * *

>next
Studio

You look around your tiny studio apartment, tucked into a corner of 178th street. "Uptown Manhattan," as someone once described it. There's a magazine on the counter, and some bills and mail pile up slowly. 

Posters hang on the walls. Your friend's LP is playing on an old turntable in the corner. It's insane you haven't cleaned this place once since you've moved here. A couch is pushed up against a big window, a grimy, scuffed rug underfoot, instruments everywhere, a kitchen nook just over there-and the apartment door to the west.

>l magazine
A glossy culture magazine-scene write-ups, tiny reviews, classifieds, and gear ads.

>look
Studio
You put a record on your tiny AT turntable in the corner of your place. Jazz floods the room.

You look around your tiny studio apartment, tucked into a corner of 178th street. "Uptown Manhattan," as someone once described it. There's a magazine on the counter, and some bills and mail pile up slowly. 

Posters hang on the walls. Your friend's LP is playing on an old turntable in the corner. It's insane you haven't cleaned this place once since you've moved here. A couch is pushed up against a big window, a grimy, scuffed rug underfoot, instruments everywhere, a kitchen nook just over there-and the apartment door to the west.

>look magazine
A glossy culture magazine-scene write-ups, tiny reviews, classifieds, and gear ads.

>look at the page
You see nothing special about the pages close-up.

PAGE 1 - Downtown Report

The scene fractured somewhere between Coltrane's sheets of sound and laptop glitch-now it's splintered into a dozen micro-movements, each with manifestos nobody reads and shows nobody promotes. Tonic's booking experimental Mondays. The Knitting Factory moved. Nobody cares.

What matters: Ludlow basement sessions where the piano's out of tune and the drummer studied in Berlin. Bring changes in three flats or go home.

Take the F train to Delancey Street. Exit, walk south on Essex, turn right on Delancey, left on Ludlow. Listen for it.

[Payphone classifieds page 6. Actually dial the numbers-email is for squares.]

* * *

>next
Studio

You look around your tiny studio apartment, tucked into a corner of 178th street. "Uptown Manhattan," as someone once described it. There's a magazine on the counter, and some bills and mail pile up slowly. 

Posters hang on the walls. Your friend's LP is playing on an old turntable in the corner. It's insane you haven't cleaned this place once since you've moved here. A couch is pushed up against a big window, a grimy, scuffed rug underfoot, instruments everywhere, a kitchen nook just over there-and the apartment door to the west.

>look a the bills
Envelopes with complicated feelings about you. One looks friendly. The rest do not.

>look at friendly
Handwritten return address. The vibe is "finally, something nice."

>open
What do you want to open?

>open mail
It isn't something you can open.

>look at window
(the window)
Streetlights smear across the glass; the city hums behind it.

>look at city
A low, constant hush: buses sighing, a scooter whining three octaves too high, someone laughing like midnight owes them money.

>look at instruments
Which do you mean, the saxophone, the guitar or the instruments?

>the instruments
Which do you mean, the saxophone, the guitar or the instruments?

>the guitar
Six strings and a history of late rent.

>the couch
I didn't understand that sentence.

>look at couch
It's certianly seen better days, but still the best place to crash between gigs. That is, if you ever get any gigs in this city, loser.

*BRRRRING* The wall phone bursts to life. (ANSWER PHONE to pick up.)

>answer phone
You step over to the wall phone.

Studio (on the phone nook)
You look around your tiny studio apartment, tucked into a corner of 178th street. "Uptown Manhattan," as someone once described it to you. There's a magazine on the counter, and bills and mail pile up slowly. There's a couch pushed up against a big window, a grimy, scuffed rug underfoot, a wall phone by the door, instruments everywhere and a kitchen nook just over there.

You can see a couch, a saxophone, a guitar, a some bills and mail and a magazine here.

"Hey. It's Rena." The voice sits somewhere between a yawn and a dare. "You should come out-Tall's is running a late jam tonight."

1) "What's up? Sell me."
2) "Tonight? I'm wrecked."
3) "Rena who?"

[Type 1, 2, or 3. HANG UP to end the call.]
You're on the phone. Choose 1-3, or type HANG UP.

>3
"Rena. Drummer. The van. The sticks. The patience." You can hear her grin. "Tall's jam. Tonight."

1) "Right. Why me?"
2) "Still a maybe."
3) "I don't even know the book."

>3
"It's a jam, not a recital. Call something in Bb, listen hard, lay back on the head. Trust me." A soft laugh. "Tall's. Tonight."
You open your mouth for directions. Too late. She's gone.

>leave room
I only understood you as far as wanting to leave.

>go to door
You can't see any such thing.

>look at doore
You can't see any such thing.

>look at door
The exit. On it: a battered subway map and more tape residue.

* * *

>next
Studio

You look around your tiny studio apartment, tucked into a corner of 178th street. "Uptown Manhattan," as someone once described it. There's a magazine on the counter, and some bills and mail pile up slowly. 

Posters hang on the walls. Your friend's LP is playing on an old turntable in the corner. It's insane you haven't cleaned this place once since you've moved here. A couch is pushed up against a big window, a grimy, scuffed rug underfoot, instruments everywhere, a kitchen nook just over there-and the apartment door to the west.

>look magazine
A glossy culture magazine-scene write-ups, tiny reviews, classifieds, and gear ads. [try looking at the page]

>look at page
You see nothing special about the pages close-up.

PAGE 1 - Downtown Report

The scene fractured somewhere between Coltrane's sheets of sound and laptop glitch-now it's splintered into a dozen micro-movements, each with manifestos nobody reads and shows nobody promotes. Tonic's booking experimental Mondays. The Knitting Factory moved. Nobody cares.

What matters: Tall's basement sessions where the piano's out of tune and the drummer studied in Berlin. Bring changes in three flats or go home.

Take the F train to Delancey Street. Exit, walk south on Essex, turn right on Delancey, left on Ludlow. Listen for it.

[Payphone classifieds page 6. Next Page?]

>look at current page
You can't see any such thing.

>yes
That was a rhetorical question.

>next page
PAGE 2 - On Technique & Silence

Monk said the piano ain't got no wrong notes. He was half-right. The wrong note is the one you don't commit to.

Downtown's full of conservatory kids playing Bergonzi patterns over "Stella" like they're decoding the Rosetta Stone. Meanwhile the guy who dropped out sophomore year is making the room breathe because he learned space before speed.

The late set isn't about your Transcriptions folder. It's about making eye contact with the bassist during the bridge and meaning it.

Ornette said learn the changes, then forget them. He was completely right. [Next Page?]

>yes
That was a rhetorical question.

>y
That was a rhetorical question.

>next
PAGE 3 - Listening Notes
 Willisau Concert 1973 (import, good luck finding it) - Cecil Taylor, 47 minutes, no breaths. Sounds like architecture collapsing inward. Essential.
 Pier 34 Tape (circulating CD-R) - Two basses, prepared guitar, traffic from FDR Drive. Recorded 2 a.m. July, sounds like humidity.
 The Kln Concert - Everyone owns it, nobody admits they cry during Part IIc.

If your speakers can't reproduce a piano's lower register, you're listening to outlines. Borrow actual monitors or wait.[Next Page?]
*BRRRRING* The wall phone bursts to life. (ANSWER PHONE to pick up.)

>answer phone
"Hey. It's Rena." The voice sits somewhere between a yawn and a dare. "You should come out-Tall's is running a late jam tonight."

1) "What's up? Sell me."
2) "Tonight? I'm wrecked."
3) "Rena who?"

[Type 1, 2, or 3. HANG UP to end the call.]

* * *

>next
Studio

You look around your tiny studio apartment, tucked into a corner of 178th street. "Uptown Manhattan," as someone once described it. There's a magazine on the counter, and some bills and mail pile up slowly. 

Posters hang on the walls. Your friend's LP is playing on an old turntable in the corner. It's insane you haven't cleaned this place once since you've moved here. A couch is pushed up against a big window, a grimy, scuffed rug underfoot, instruments everywhere, a kitchen nook just over there-and the apartment door to the west.

>n
You can't go that way.

>n
You can't go that way.

>n
You can't go that way.

*BRRRRING* The wall phone bursts to life. (ANSWER PHONE to pick up.)

>answer phone
You step over to the wall phone.

Studio (on the phone nook)
You look around your tiny studio apartment, tucked into a corner of 178th street. "Uptown Manhattan," as someone once described it. There's a magazine on the counter, and some bills and mail pile up slowly. A couch is pushed up against a big window, a grimy, scuffed rug underfoot, instruments everywhere, a kitchen nook just over there-and the apartment door to the west.

You can see a door, a couch, a saxophone, a guitar, a some bills and mail (closed) and a magazine here.

"Hey. It's Rena." The voice sits somewhere between a yawn and a dare. "You should come out-Tall's is running a late jam tonight."

1) "What's up? Sell me."
2) "Tonight? I'm wrecked."
3) "Rena who?"

[Type 1, 2, or 3. HANG UP to end the call.]

>2
"Wrecked's fine. Play one tune, drink one drink, shake three hands. That's all. You'll thank me tomorrow."

1) "One tune, huh? Convince me."
2) "Pass."
3) "Feels risky without a call."

* * *

>2
"Fine. Be tired on stage. Two choruses and bounce. Tall's. Tonight." The confidence leaves no wedge for argument.
You draw breath to ask where it is-click. Dead line. No address.

>l
Studio (on the phone nook)
You look around your tiny studio apartment, tucked into a corner of 178th street. "Uptown Manhattan," as someone once described it. There's a magazine on the counter, and some bills and mail pile up slowly. A couch is pushed up against a big window, a grimy, scuffed rug underfoot, instruments everywhere, a kitchen nook just over there-and the apartment door to the west.

You can see a door, a couch, a saxophone, a guitar, a some bills and mail (closed) and a magazine here.

>look magazine
A glossy culture magazine-scene write-ups, tiny reviews, classifieds, and gear ads. EXAMINE PAGES, then type NEXT or PREVIOUS to flip.

>take magazine
Taken.

>i
You are carrying:
  a magazine

>look magazine
A glossy culture magazine-scene write-ups, tiny reviews, classifieds, and gear ads. EXAMINE PAGES, then type NEXT or PREVIOUS to flip.

>x
(the magazine)
A glossy culture magazine-scene write-ups, tiny reviews, classifieds, and gear ads. EXAMINE PAGES, then type NEXT or PREVIOUS to flip.

>x pages
You see nothing special about the pages close-up.

PAGE 1 - Scene Report: Lower East Side

Tall's has quietly become the late-night hang-basement room, red door, low ceiling, louder conversations. If you can play in Bb, the house will make space.

Where: 184 Ludlow St (downstairs). Trains: F/M/J/Z to Delancey-Essex.

Also noted: Kite Studios expands hours; Mr. Lin opens waitlist.

[Numbers & classifieds on later pages. You can DIAL numbers from the wall phone.]

[Type NEXT or PREVIOUS to flip pages.]

>3
I didn't understand that sentence.

>2
I didn't understand that sentence.

>next page
PAGE 2 - Rehearsal & Rooms
 Kite Studios (24h lockout) - 555-0145
 Bulletin: "late set players welcome" at Tall's (see page 1).

[Type NEXT or PREVIOUS to flip pages.]

>next page
PAGE 3 - Repairs & Services
 Mr. Lin (Sax repair) - 555-0177
 Amp Doctor - 555-0158
Tip: buzzing? Check your ground first.

[Type NEXT or PREVIOUS to flip pages.]

>call 555 0158
You tap the keypad: 555 0158.

A crisp voice: "Operator. What city and number please?" You panic and hang up politely.

>l
Studio (on the phone nook)
You look around your tiny studio apartment, tucked into a corner of 178th street. "Uptown Manhattan," as someone once described it. There's a magazine on the counter, and some bills and mail pile up slowly. A couch is pushed up against a big window, a grimy, scuffed rug underfoot, instruments everywhere, a kitchen nook just over there-and the apartment door to the west.

You can see a door, a couch, a saxophone, a guitar and a some bills and mail (closed) here.

>w
(first getting off the phone nook)
You step back from the wall phone.

(first opening the door)
Subway - pick a stop:
1) Delancey-Essex
2) Spring St
3) Prince St
4) Canal St
5) Hoyt-Schermerhorn

(The magazine said Tall's is at 184 Ludlow, F/M/J/Z to Delancey-Essex.)

[Type a number (1-5) or the stop name.]
(subway)

>1
Delancey Street
Lower East Side: neon bleed, late traffic, bass from a basement somewhere. A red door marked Tall's crouches under a short run of stairs. (And yeah-the address matches the magazine: 184 Ludlow.)

Delancey Street
Lower East Side: neon bleed, late traffic, bass from a basement somewhere. A red door marked Tall's crouches under a short run of stairs. (And yeah-the address matches the magazine: 184 Ludlow.)

>z
Time passes.

>look me
As good-looking as ever.

>eat magazine
That's plainly inedible.

>enter tall's
That's not something you can enter.

* * *

>next
Studio

You look around your tiny studio apartment, tucked into a corner of 178th street. "Uptown Manhattan," as someone once described it. There's a magazine on the counter, and some bills and mail pile up slowly. 

Posters hang on the walls. Your friend's LP is playing on an old turntable in the corner. It's insane you haven't cleaned this place once since you've moved here. A couch is pushed up against a big window, a grimy, scuffed rug underfoot, instruments everywhere, a kitchen nook just over there-and the apartment door to the west.

>next
PAGE 2 - Rehearsal & Rooms
 Kite Studios (24h lockout) - 555-0145
 Bulletin: "late set players welcome" at Tall's (see page 1).

[Type NEXT or PREVIOUS to flip pages.]

>next
PAGE 3 - Repairs & Services
 Mr. Lin (Sax repair) - 555-0177
 Amp Doctor - 555-0158
Tip: buzzing? Check your ground first.

[Type NEXT or PREVIOUS to flip pages.]

>next
PAGE 4 - Classifieds
 Landlord Office - 555-0119
 Rides: Yellow Cab - 555-0129
 Pizza Planet - 555-0199 (two toppings after midnight).

[Type NEXT or PREVIOUS to flip pages.]

>next
PAGE 1 - Scene Report: Lower East Side

Tall's has quietly become the late-night hang-basement room, red door, low ceiling, louder conversations. If you can play in Bb, the house will make space.

Where: 184 Ludlow St (downstairs). Trains: F/M/J/Z to Delancey-Essex.

Also noted: Kite Studios expands hours; Mr. Lin opens waitlist.

[Numbers & classifieds on later pages. You can DIAL numbers from the wall phone.]

[Type NEXT or PREVIOUS to flip pages.]

>next
PAGE 2 - Rehearsal & Rooms
 Kite Studios (24h lockout) - 555-0145
 Bulletin: "late set players welcome" at Tall's (see page 1).

[Type NEXT or PREVIOUS to flip pages.]

* * *

>next
PAGE 3 - Repairs & Services
 Mr. Lin (Sax repair) - 555-0177
 Amp Doctor - 555-0158
Tip: buzzing? Check your ground first.

[Type NEXT or PREVIOUS to flip pages.]

>next
PAGE 4 - Classifieds
 Landlord Office - 555-0119
 Rides: Yellow Cab - 555-0129
 Pizza Planet - 555-0199 (two toppings after midnight).

[Type NEXT or PREVIOUS to flip pages.]
*BRRRRING* The wall phone bursts to life. (ANSWER PHONE to pick up.)

>next
PAGE 1 - Scene Report: Lower East Side

Tall's has quietly become the late-night hang-basement room, red door, low ceiling, louder conversations. If you can play in Bb, the house will make space.

Where: 184 Ludlow St (downstairs). Trains: F/M/J/Z to Delancey-Essex.

Also noted: Kite Studios expands hours; Mr. Lin opens waitlist.

[Numbers & classifieds on later pages. You can DIAL numbers from the wall phone.]

[Type NEXT or PREVIOUS to flip pages.]

>nexta
I didn't understand that sentence.

>answer
"Hey. It's Rena." The voice sits somewhere between a yawn and a dare. "You should come out-Tall's is running a late jam tonight."

1) "What's up? Sell me."
2) "Tonight? I'm wrecked."
3) "Rena who?"

[Type 1, 2, or 3. HANG UP to end the call.]

>1
"Late set. House trio is killing, horns rotate in, everyone listens. You need to be seen."

1) "Okay, make your pitch."
2) "I don't have the energy."
3) "Do they even let walk-ins?"

>1
"You sound good. You need reps. People there can hire you. And the room forgives. Show up, take a chorus, leave a name." A beat. "So... tonight."
You draw breath to ask where it is-click. Dead line. No address.

>w
Subway - pick a stop:
1) Delancey-Essex
2) Spring St (6)
3) Prince St (R/W)
4) Canal St (A/C/E)
5) Hoyt-Schermerhorn
6) 14 St-Union Sq
7) W 4 St-Wash Sq
8) 34 St-Herald Sq
9) Times Sq-42 St
10) Grand St (B/D)
11) Bedford Av (L)
12) Atlantic Av-Barclays Ctr
13) 2 Av (F)
14) Broadway-Lafayette
15) Essex St (J/M/Z)
16) 1 Av (L)
17) 7 Av-Park Slope
18) Nostrand Av (A/C)
19) Queensboro Plaza
20) Myrtle-Wyckoff Avs

[Type a number (1-20).]
(subway)

>1
Delancey Street
Lower East Side: neon bleed, late traffic, bass from a basement somewhere. A red door marked Tall's crouches under a short run of stairs. (And yeah-the address matches the magazine: 184 Ludlow.)

>enter tall's
You can't see any such thing.

>look door
You can't see any such thing.

>look stairs
You can't see any such thing.

* * *

>next
Studio

You look around your tiny studio apartment, tucked into a corner of 178th street. "Uptown Manhattan," as someone once described it. There's a magazine on the counter, and some bills and mail pile up slowly. 

Posters hang on the walls. Your friend's LP is playing on an old turntable in the corner. It's insane you haven't cleaned this place once since you've moved here. A couch is pushed up against a big window, a grimy, scuffed rug underfoot, instruments everywhere, a kitchen nook just over there-and the apartment door to the west.

>w
You shouldn't leave if you have nowhere to go. Maybe figure out your night first.

>look at mail
A rubber-banded stack: some official windows, some handwritten. You could OPEN it.

>open mail
You peel the rubber band and spread things out: a friendly envelope, a landlord envelope, and a ConEd envelope.

>open friendly
You open the friendly envelope, revealing a handwritten letter.

>look
Studio
You look around your tiny studio apartment, tucked into a corner of 178th street. "Uptown Manhattan," as someone once described it. There's a magazine on the counter, and some bills and mail pile up slowly. A couch is pushed up against a big window, a grimy, scuffed rug underfoot, instruments everywhere, a kitchen nook just over there-and the apartment door to the west.

You can see a door, a couch, a saxophone, a guitar, a some bills and mail (in which are a friendly envelope (in which is a handwritten letter), a landlord envelope (closed) and a coned envelope (closed)) and a magazine here.

>look at letter
Hey-Proud of you for making the move. Call if you need a couch, or a pep talk. PS: Your tone on "Body and Soul" gives me chills. -M

>look at landlord envelope
Printed window, stern font. Smells faintly of copier ozone.

*BRRRRING* The wall phone bursts to life. (ANSWER PHONE to pick up.)

>answer phone
You step over to the wall phone.

Studio (on the phone nook)
You look around your tiny studio apartment, tucked into a corner of 178th street. "Uptown Manhattan," as someone once described it. There's a magazine on the counter, and some bills and mail pile up slowly. A couch is pushed up against a big window, a grimy, scuffed rug underfoot, instruments everywhere, a kitchen nook just over there-and the apartment door to the west.

You can see a door, a couch, a saxophone, a guitar, a some bills and mail (in which are a friendly envelope (in which is a handwritten letter), a landlord envelope (closed) and a coned envelope (closed)) and a magazine here.

"Hey. It's Rena." The voice sits somewhere between a yawn and a dare. "You should come out-Tall's is running a late jam tonight."

1) "What's up? Sell me."
2) "Tonight? I'm wrecked."
3) "Rena who?"

[Type 1, 2, or 3. HANG UP to end the call.]

>1
"Late set. House trio is killing, horns rotate in, everyone listens. You need to be seen."

1) "Okay, make your pitch."
2) "I don't have the energy."
3) "Do they even let walk-ins?"

* * *

>1
"You sound good. You need reps. People there can hire you. And the room forgives. Show up, take a chorus, leave a name." A beat. "So... tonight."
You draw breath to ask where it is-click. Dead line. No address.

>look
Studio (on the phone nook)
You look around your tiny studio apartment, tucked into a corner of 178th street. "Uptown Manhattan," as someone once described it. There's a magazine on the counter, and some bills and mail pile up slowly. A couch is pushed up against a big window, a grimy, scuffed rug underfoot, instruments everywhere, a kitchen nook just over there-and the apartment door to the west.

You can see a door, a couch, a saxophone, a guitar, a some bills and mail (in which are a friendly envelope (in which is a handwritten letter), a landlord envelope (closed) and a coned envelope (closed)) and a magazine here.

>w
(first getting off the phone nook)
You step back from the wall phone.

(first opening the door)
Subway - pick a stop:
1) Delancey-Essex
2) Spring St
3) Prince St
4) Canal St
5) Hoyt-Schermerhorn

[Type a number (1-5) or the stop name.]
(subway)

>2
You ride down, second-guess it on the platform, and circle back. Maybe actually read the magazine first.

Studio
You look around your tiny studio apartment, tucked into a corner of 178th street. "Uptown Manhattan," as someone once described it. There's a magazine on the counter, and some bills and mail pile up slowly. A couch is pushed up against a big window, a grimy, scuffed rug underfoot, instruments everywhere, a kitchen nook just over there-and the apartment door to the west.

You can see a door, a couch, a saxophone, a guitar, a some bills and mail (in which are a friendly envelope (in which is a handwritten letter), a landlord envelope (closed) and a coned envelope (closed)) and a magazine here.

Studio
You look around your tiny studio apartment, tucked into a corner of 178th street. "Uptown Manhattan," as someone once described it. There's a magazine on the counter, and some bills and mail pile up slowly. A couch is pushed up against a big window, a grimy, scuffed rug underfoot, instruments everywhere, a kitchen nook just over there-and the apartment door to the west.

You can see a door, a couch, a saxophone, a guitar, a some bills and mail (in which are a friendly envelope (in which is a handwritten letter), a landlord envelope (closed) and a coned envelope (closed)) and a magazine here.

* * *

>next
Studio

You look around your tiny studio apartment, tucked into a corner of 178th street. "Uptown Manhattan," as someone once described it. There's a magazine on the counter, and some bills and mail pile up slowly. 

Posters hang on the walls. Your friend's LP is playing on an old turntable in the corner. It's insane you haven't cleaned this place once since you've moved here. A couch is pushed up against a big window, a grimy, scuffed rug underfoot, instruments everywhere, a kitchen nook just over there-and the apartment door to the west.

>z
Time passes.

* * *

>z
Time passes.

*BRRRRING* The wall phone bursts to life. (ANSWER PHONE to pick up.)

>answer
"It's Rena." Not a question. The voice carries last night's cigarettes and this morning's coffee. "Tall's. Late jam. You're coming."

1) "Am I? Tell me why."
2) "Tonight? I'm destroyed."
3) "Rena who?"

[Type 1, 2, or 3. HANG UP to end the call.]

>1
"Late set. House trio is killing, horns rotate in, everyone listens. You need to be seen."

1) "What's your angle here?"
2) "I'm not going."
3) "Is this an open thing or do I need an in?"

>2
You start to feel your heart beat. "Why, why why, why would I say yes to this."

* * *

I beg your pardon?

>answer phone
"Hey. It's Rena." The voice sits somewhere between a yawn and a dare. "You should come out-Tall's is running a late jam tonight."

1) "What's up? Sell me."
2) "Tonight? I'm wrecked."
3) "Rena who?"

[Type 1, 2, or 3. HANG UP to end the call.]

* * *

>l
Studio (on the phone nook)
You look around your tiny studio apartment, tucked into a corner of 178th street. "Uptown Manhattan," as someone once described it. There's a magazine on the counter, and some bills and mail pile up slowly. A couch is pushed up against a big window, a grimy, scuffed rug underfoot, instruments everywhere, a kitchen nook just over there-and the apartment door to the west.

You can see a door, a couch, a saxophone, a guitar, a some bills and mail (closed) and a magazine here.

>look at magazine
A glossy culture magazine-scene write-ups, tiny reviews, classifieds, and gear ads. EXAMINE PAGES, then type NEXT or PREVIOUS to flip.

>examine page
You see nothing special about the pages close-up.

PAGE 1 - Scene Report: Lower East Side

Tall's has quietly become the late-night hang-basement room, red door, low ceiling, louder conversations. If you can play in Bb, the house will make space.

Where: 184 Ludlow St (downstairs). Trains: F/M/J/Z to Delancey-Essex.

Also noted: Kite Studios expands hours; Mr. Lin opens waitlist.

[Numbers & classifieds on later pages. You can DIAL numbers from the wall phone.]

[Type NEXT or PREVIOUS to flip pages.]

>w
Subway - pick a stop:
1) Delancey-Essex
2) Spring St (6)
3) Prince St (R/W)
4) Canal St (A/C/E)
5) Hoyt-Schermerhorn
6) 14 St-Union Sq
7) W 4 St-Wash Sq
8) 34 St-Herald Sq
9) Times Sq-42 St
10) Grand St (B/D)
11) Bedford Av (L)
12) Atlantic Av-Barclays Ctr
13) 2 Av (F)
14) Broadway-Lafayette
15) Essex St (J/M/Z)
16) 1 Av (L)
17) 7 Av-Park Slope
18) Nostrand Av (A/C)
19) Queensboro Plaza
20) Myrtle-Wyckoff Avs

(The magazine said Tall's is at 184 Ludlow, F/M/J/Z to Delancey-Essex.)

[Type a number (1-20).]
(subway)

>1
Delancey Street
Lower East Side: neon bleed, late traffic, bass from a basement somewhere. A red door marked Tall's crouches under a short run of stairs. (And yeah-the address matches the magazine: 184 Ludlow.)

Delancey Street
Lower East Side: neon bleed, late traffic, bass from a basement somewhere. A red door marked Tall's crouches under a short run of stairs. (And yeah-the address matches the magazine: 184 Ludlow.)

* * *

>z
Time passes.

*BRRRRING* The wall phone bursts to life. (ANSWER PHONE to pick up.)

>answer
"It's Rena." Not a question. The voice carries last night's cigarettes and this morning's coffee. "Tall's. Late jam. You're coming."

1) "Am I? Tell me why."
2) "Tonight? I'm destroyed."
3) "Rena who?"

[Type 1, 2, or 3.]

>1
"Late set. House trio is killing, horns rotate in, everyone listens. You need to be seen."

1) "What's your angle here?"
2) "I'm not going."
3) "Is this an open thing or do I need an in?"

>1
Well, I suppose I'd better figure out how to get there.

* * *

>z
Time passes.

*BRRRRING* The wall phone bursts to life. (ANSWER PHONE to pick up.)

>answer phone
"It's Rena." Not a question. The voice carries last night's cigarettes and this morning's coffee. "Tall's. Late jam. You're coming."

1) "Am I? Tell me why."
2) "Tonight? I'm destroyed."
3) "Rena who?"

[Type 1, 2, or 3. HANG UP to end the call.]

>1
"Late set. House trio is killing, horns rotate in, everyone listens. You need to be seen."

1) "Okay, make your pitch."
2) "I don't have the energy."
3) "Do they even let walk-ins?"

"Because you don't sound like you're quoting anyone yet. That window closes." Traffic noise, a siren. "Room's small, ceiling's low, everyone's had two drinks minimum. You call a tune in Bb, play the form, don't overplay the bridge. If you listen, they remember. If you showboat, they remember differently." Beat. "Ludlow. Red door. Downstairs."

You start to ask which block on Ludlow, is there a sign, what time exactly-click. Line goes dead. She figured you'd either know or figure it out.

>2
I didn't understand that sentence.

* * *

>z
Time passes.

>answer
"It's Rena." Not a question. The voice carries last night's cigarettes and this morning's coffee. "Tall's. Late jam. You're coming."

1) "Am I? Tell me why."
2) "Tonight? I'm destroyed."
3) "Rena who?"

[Type 1, 2, or 3. HANG UP to end the call.]

>2
"Good. Exhausted reads honest." A lighter flicks on her end. "One tune. Make it not embarrassing. Three people in that room book gigs. That's it. That's the math."

1) "One tune gets me what, exactly?"
2) "Not interested."
3) "Walking into a jam cold sounds like a bad idea."

>1
"Because you don't sound like you're quoting anyone yet. That window closes." Traffic noise, a siren. "Room's small, ceiling's low, everyone's had two drinks minimum. You call a tune in Bb, play the form, don't overplay the bridge. If you listen, they remember. If you showboat, they remember differently." Beat. "Ludlow. Red door. Downstairs."

You start to ask which block on Ludlow, is there a sign, what time exactly-click. Line goes dead. She figured you'd either know or figure it out.

>l
Studio (on the phone nook)
You put a record on your tiny AT turntable in the corner of your place. Jazz floods the room.

You look around your tiny studio apartment, tucked into a corner of 178th street. "Uptown Manhattan," as someone once described it. There's a magazine on the counter, and some bills and mail pile up slowly. 

Posters hang on the walls. Your friend's LP is playing on an old turntable in the corner. It's insane you haven't cleaned this place once since you've moved here. A couch is pushed up against a big window, a grimy, scuffed rug underfoot, instruments everywhere, a kitchen nook just over there-and the apartment door to the west.

>leave phone nook
I only understood you as far as wanting to leave.

* * *

For the first time since you stepped onstage, you notice how hard your heart is beating.

[Press any key.]

>take saxophone
Taken.

>i
You are carrying:
  a saxophone

* * *

For the first time since you stepped onstage, you notice how hard your heart is beating.

[Press any key.]

>w
You shouldn't leave if you have nowhere to go. Maybe figure out your night first, bro. Are you gonna do something, or wimp out and stay here and watch Sex and the City again?

>l instruments
Which do you mean, the saxophone, the guitar or the instruments?

>sax
I remember when dad gave me this horn. I was just old enough to save all my lunch money to buy a beginner Yamaha horn, anything would have been better than the school model. 
When I got home from my last day of 11th grade, he had a shit-eating grin on his face. He was waiting for me to work hard enough to prove I wanted a nicer sax, and then he gave me his Selmer. What an asshole. Can't be too mad. Your four-track is parked nearby-do you think it likes hearing you practice long tones all day?

* * *

For the first time since you stepped onstage, you notice how hard your heart is beating.

[Press any key.]

>z
Time passes.

* * *

>2
I didn't understand that sentence.

>answer phone
"It's Rena." Not a question. The voice carries last night's cigarettes and this morning's coffee. You can hear the faint hiss of street traffic behind her words. "Tall's. Late jam. You're coming." There's a pause filled with the sound of a lighter flicking, then an exhale.

1) "Am I? Tell me why."
2) "Tonight? I'm destroyed."
3) "Rena who?"

[Type 1, 2, or 3.]

>22
Pick 1, 2, or 3.

>2
"Good. Exhausted reads honest." A bus sighs past on her end. "One tune. Make it not embarrassing. Three people in that room book gigs. That's it. That's the math." She pauses. "And before you ask - no, I'm not getting anything out of this except maybe seeing you not completely waste whatever talent you haven't drunk away yet."

1) "One tune gets me what, exactly?"
2) "Not interested."
3) "Walking into a jam cold sounds like a bad idea."

>2
"Yeah you are. Play tired. Chet Baker made a career out of it." Her voice gets an edge. "Three minutes. In and out. Tall's cares if you improved the last eight bars, not if you're chipper about it." Not asking anymore. "Look, I'm doing this once. Next time you're on your own." You hear her take a long drag. "You want to be playing weddings in Jersey? Keep making excuses.""Marcus will be there. He books the Tuesday residency at Zinc." Another beat. "You know what a residency pays? It pays your ConEd bill, that's what."

1) "What if I choke?"
2) "What time?"
3) "Who else is playing?"

>2
Well, I suppose I'd better figure out how to get there.

I beg your pardon?

>take sax
Taken.

* * *

>z
Time passes.

>answer
"It's Rena." Not a question. The voice carries last night's cigarettes and this morning's coffee. You can hear the faint hiss of street traffic behind her words. "Tall's. Late jam. You're coming." There's a pause filled with the sound of a lighter flicking, then an exhale.

1) "Am I? Tell me why."
2) "Tonight? I'm destroyed."
3) "Rena who?"

[Type 1, 2, or 3.]

>2
"Good. Exhausted reads honest." A bus sighs past on her end. "One tune. Make it not embarrassing. Three people in that room book gigs. That's it. That's the math." She pauses. "And before you ask - no, I'm not getting anything out of this except maybe seeing you not completely waste whatever talent you haven't drunk away yet."

1) "One tune gets me what, exactly?"
2) "Not interested."
3) "Walking into a jam cold sounds like a bad idea."

* * *

>take sax
Taken.

>w
(first opening the door)

Hallway
Dim, echoey. Stairs down to the street, smell of dust and last night's takeout.

* * *

>down
Subway - pick a stop:
1) Delancey-Essex
2) Spring St (6)
3) Prince St (R/W)
4) Canal St (A/C/E)
5) Hoyt-Schermerhorn
6) 14 St-Union Sq
7) W 4 St-Wash Sq
8) 34 St-Herald Sq
9) Times Sq-42 St
10) Grand St (B/D)
11) Bedford Av (L)
12) Atlantic Av-Barclays Ctr
13) 2 Av (F)
14) Broadway-Lafayette
15) Essex St (J/M/Z)
16) 1 Av (L)
17) 7 Av-Park Slope
18) Nostrand Av (A/C)
19) Queensboro Plaza
20) Myrtle-Wyckoff Avs

[Type a number (1-20).]
(subway)

>1
Delancey Street
Lower East Side: neon bleed, late traffic, bass from a basement somewhere. A red door marked Tall's crouches under a short run of stairs. (And yeah-the address matches the magazine: 184 Ludlow.)

>look door
You can't see any such thing.

>l
Delancey Street
Lower East Side: neon bleed, late traffic, bass from a basement somewhere. A red door marked Tall's crouches under a short run of stairs. (And yeah-the address matches the magazine: 184 Ludlow.)

>enter
You must supply a noun.

>enter tall's
You can't see any such thing.

>e
You can't go that way.

>back
I didn't understand that sentence.

* * *

>z
Time passes.

>answer
"It's Rena." Not a question. The voice carries last night's cigarettes and this morning's coffee. You can hear the faint hiss of street traffic behind her words. "Tall's. Late jam. You're coming."

1) "Am I? Tell me why."
2) "Tonight? I'm destroyed."
3) "Rena who?"

[Type 1, 2, or 3.]

>1
"Late set. House trio is killing, horns rotate in, everyone listens. You need to be seen."

1) "What's your angle here?"
2) "I'm not going."
3) "Is this an open thing or do I need an in?"

>2
fuck

* * *

>1
"Late set. House trio is killing, horns rotate in, everyone listens. You need to be seen."

1) "What's your angle here?"
2) "I'm not going."
3) "Is this an open thing or do I need an in?"

>2
Well, I suppose I'd better figure out how to get there.

>look door
You see nothing special about the door.

>leave
You step back from the wall phone.

>leave room
I only understood you as far as wanting to leave.

>leave door
I only understood you as far as wanting to leave.

>leave through the door
I only understood you as far as wanting to leave.

>go through the door
(first opening the door)

Hallway
Dim, echoey. Stairs down to the street, smell of dust and last night's takeout.

>go downstairs
You can't see any such thing.

* * *

>z
Time passes.

*BRRRRING* The wall phone bursts to life. (ANSWER PHONE to pick up.)

>answer
"It's Rena." Not a question. The voice carries last night's cigarettes and this morning's coffee. You can hear the faint hiss of street traffic behind her words. "Tall's. Late jam. You're coming." There's a pause filled with the sound of a lighter flicking, then an exhale.

1) "Am I? Tell me why."
2) "Tonight? I'm destroyed."
3) "Rena who?"

[Type 1, 2, or 3.]

* * *

>2
"Good. Exhausted reads honest." A bus sighs past on her end. "One tune. Make it not embarrassing. Three people in that room book gigs. That's it. That's the math." She pauses. "And before you ask - no, I'm not getting anything out of this except maybe seeing you not completely waste whatever talent you haven't drunk away yet."

1) "One tune gets me what, exactly?"
2) "Not interested."
3) "Walking into a jam cold sounds like a bad idea."

>3
"It's a session, not a dissertation defense. "Confirmation" if you want respect, "Autumn Leaves" if you want to actually play. Play the head, don't rush, like you do sometimes. The form will do the work." A short laugh. "Or play "Epistrophe" and watch everyone hate you. Your choice." She already assumes you're showing."Marcus will be there. He books the Tuesday residency at Zinc." Another beat. "You know what a residency pays? It pays your ConEd bill, that's what."

1) "What if I choke?"
2) "What time?"
3) "Who else is playing?"

>2
Well, I suppose I'd better figure out how to get there.

* * *

>w
(first opening the door)

Hallway
Dim, echoey. Stairs down to the street, smell of dust and last night's takeout.

>down
You can't go that way.

>d
You can't go that way.

>out
But you aren't in anything at the moment.

>leave
But you aren't in anything at the moment.

>exit
But you aren't in anything at the moment.

>go to the street
You can't see any such thing.

>leave
But you aren't in anything at the moment.

* * *

>z
Time passes.

>1
I didn't understand that sentence.

>answer
"It's Rena." Not a question. The voice carries last night's cigarettes and this morning's coffee. You can hear the faint hiss of street traffic behind her words. "Tall's. Late jam. You're coming." There's a pause filled with the sound of a lighter flicking, then an exhale.

1) "Am I? Tell me why."
2) "Tonight? I'm destroyed."
3) "Rena who?"

[Type 1, 2, or 3.]

* * *

>1
"Tenor," he repeats, like he's tasting the word. "My son played tenor. What kind you got there?"

1) "Selmer Mark VI."
2) "Just a student model."
3) "Why?"

>2
He smiles sadly. "They're all special when they're yours. My son's horn was just a Yamaha at first, but he made it sing." He looks at your hands. "You got good hands. Strong. You'll do fine."

The train slows into Delancey Street. "This is you," he says. As you stand to leave, he adds, "Remember-it's just music. The notes will be there tomorrow, no matter what happens tonight."

Delancey Street
Lower East Side: neon bleed, late traffic, bass thumping from a basement somewhere. A red door marked Tall's crouches under a short run of stairs. (And yeah-the address matches the magazine: 184 Ludlow.) The sound of a piano trio filters through the door-someone playing "Autumn Leaves" with more feeling than you thought possible tonight.

>go in door
Your hand finds the cold brass knob. Through the wood, you can feel the vibration of the bass, the shimmer of the ride cymbal. Your heart is pounding so hard you're sure everyone on the street can hear it.

This is it. You could still turn around. Take the train back uptown. Watch TV. Pretend this never happened.

But then you think of the old man on the train. Your dad's horn in its case. The empty pill bottle on your counter. The professor's letter. All the reasons to run, and the one reason to stay.

You take a deep breath.

Do you go in? (Type YES or NO.)

>in
Type IN or OUT.

>in
Type IN or OUT.

>yes
You're at the threshold. Type IN to enter or OUT to walk away.

>in
Type IN or OUT.

>IN
Type IN or OUT.

* * *

>z
Time passes.

>answeer
I didn't understand that sentence.

>answer
"It's Rena." Not a question. The voice carries last night's cigarettes and this morning's coffee. You can hear the faint hiss of street traffic behind her words. "Tall's. Late jam. You're coming." There's a pause filled with the sound of a lighter flicking, then an exhale.

1) "Am I? Tell me why."
2) "Tonight? I'm destroyed."
3) "Rena who?"

[Type 1, 2, or 3.]

* * *

>w
Forgetting something?

>take sax
Taken.

* * *

>1
Subway Train Correct
The F train rumbling downtown. The old man watches you with patient curiosity.

The downtown F train rattles through the tunnel, a metallic heartbeat under the city. The car is half-empty-a few late-shift workers, a couple making out by the doors, and an old man with a weathered face and kind eyes sitting across from you. He nods at your sax case.

"That a sax?" he asks, his voice gravelly like he's smoked a thousand cigarettes and drunk a thousand cups of coffee.

1) "Yeah, tenor."
2) "Just heading to a jam."
3) Nod silently

>2
"A jam," he says, smiling. "Tall's? I used to play there back in the day. Place hasn't changed." He eyes your case. "What kind of horn you bringing?"

1) "Selmer Mark VI."
2) "Nothing special."
3) "You know Tall's?"

>3
"I know the look," he says. "The weight of it. My son used to get that same look before gigs." He pats your knee. "The horn chooses you, not the other way around. Whatever you're carrying, let it come out in the music."

The train slows into Delancey Street. "This is you," he says. As you stand to leave, he adds, "Remember-it's just music. The notes will be there tomorrow, no matter what happens tonight."

Delancey Street
Lower East Side: neon bleed, late traffic, bass thumping from a basement somewhere. A red door marked Tall's crouches under a short run of stairs. (And yeah-the address matches the magazine: 184 Ludlow.) The sound of a piano trio filters through the door-someone playing "Autumn Leaves" with more feeling than you thought possible tonight.

>enter
You must supply a noun.

>enter talls
Your hand finds the cold brass knob. Through the wood, you can feel the vibration of the bass, the shimmer of the ride cymbal. Your heart is pounding so hard you're sure everyone on the street can hear it.

This is it. You could still turn around. Take the train back uptown. Watch TV. Pretend this never happened.

But then you think of the old man on the train. Your dad's horn in its case. The empty pill bottle on your counter. The professor's letter. All the reasons to run, and the one reason to stay.

You take a deep breath.

Do you go in? (Type YES or NO.)

>yes
Type YES or NO.

>yes
Type YES or NO.

>YES
Type YES or NO.

>yes
Type YES or NO.

* * *

>z
Time passes.

>answer phone
"It's Rena." Not a question. The voice carries last night's cigarettes and this morning's coffee. You can hear the faint hiss of street traffic behind her words. "Tall's. Late jam. You're coming." There's a pause filled with the sound of a lighter flicking, then an exhale.

1) "Am I? Tell me why."
2) "Tonight? I'm destroyed."
3) "Rena who?"

[Type 1, 2, or 3.]

>2
"Good. Exhausted reads honest." A bus sighs past on her end. "One tune. Make it not embarrassing. Three people in that room book gigs. That's it. That's the math." She pauses. "And before you ask - no, I'm not getting anything out of this except maybe seeing you not completely waste whatever talent you haven't drunk away yet."

1) "One tune gets me what, exactly?"
2) "Not interested."
3) "Walking into a jam cold sounds like a bad idea."

* * *

>3
"It's a session, not a dissertation defense. "Confirmation" if you want respect, "Autumn Leaves" if you want to actually play. Play the head, don't rush, like you do sometimes. The form will do the work." A short laugh. "Or play "Epistrophe" and watch everyone hate you. Your choice." She already assumes you're showing."Marcus will be there. He books the Tuesday residency at Zinc." Another beat. "You know what a residency pays? It pays your ConEd bill, that's what."

1) "What if I choke?"
2) "What time?"
3) "Who else is playing?"

>1
Well, I suppose I'd better figure out how to get there.